1211122114
2C00000044
1011444001
1014214201
1021444201
2024441001
1004444012
2100411011
1440000C11
1411021111
5555055555
5555055555
1112055512
2100055101
4001251002
2042555104
4011555201
1002525001
1100000024
1121144124
