1211122114
2C1100000044
1011444001
1014214201
1024444201
2024C4241001
1004444012
2100411011
1440000C2111
6411026611
5555055555
5555055555
16C312055566
2100055101
4001251002
2042555104
40C011555201
1002525001
1C2000000021
1121144121
